wwwwwwwwwwwwwwwww
w               w
w b b b b b b b w
w               w
w b b b b b b b w
w               w
w b b b b b b b w
w               w
w b b b b b b b w
w               w
w               w
w               w
w       o       w
w               w
w      ppp      w
w               w
